WWWWWWWWWWWWWWWWWWWW
P        W         W
W   WWW  W  W  W   W
W   W    W  W  W   W
W   W  WWWWWW  W   W
W   W       W  W   W
W   WWWWW   W  W   W
W           W  W   W
W  WWWWWW   W  W   W
W  W        W  W   W
W  W   WWWWWW  W   W
W  W           W   W
W  WWWWWWWWWWWWW   W
W                  G
WWWWWWWWWWWWWWWWWWWW